1100110010
0A10101101
0000001001
0011000100
0110010010
1110100011
1010111100
10110010B1
0101101110
1110101111

